R  1000 750

NO ./texture/grey_wall.XPM
SO ./texture/grey_wall.XPM
WE ./texture/grey_wall.XPM
EA./texture/grey_wall.XPM
S ./texture/frfrance.XPM

F 86,125,70
C 0,191,235

11111111111111111111111111111
10000000000000001111111100001
10000000000000001111111100001
10000000000000000000000000001
10000000000000000000000000001
10111111111111000000000000001
10111111111111000000000000001
10000000000000N00000000000001
10000000000000000000000000001
10000000000000000000000000001
10000020000000111111111111111
10000000000000111111111111111
10000000000000000000000000001
11111111111111111111111111111

NX  ./maps/map1.cub
