R  1000 750

NO ./texture/grey_wall.XPM
SO ./texture/grey_wall.XPM
WE ./texture/grey_wall.XPM
EA./texture/grey_wall.XPM
S ./texture/frfrance.XPM

F 86,125,70
C 0,191,235


NX ./maps/map2.cub

11111111111111111111111111111
10000000000000001111111100001
10000000000000001111111100001
10000000000000000000000000001
10000000000000000000000000001
101111111111110000000000000011011
101111111111110000000000000000001
10000000000000N000000000000000001
100000000000000000000000000011111
10000000000000000000000000001
10000020000000111111111111111
10000000000000111111111111111
10000000000000000000000000001
11111111111111111111111111111
