R  1200 700

NO ./texture/brick_wall.XPM
SO ./texture/brick_wall.XPM
WE ./texture/wood_wall.XPM
EA ./texture/wood_wall.XPM
S ./texture/frfrance.XPM

F 86,125,70
C 0,191,235

11111111111111111111111111111
12222222222222222222222222221
12222222222222222222222222221
12222222222222222222222222221
12222222222222222222222222221
12222222222222222222222222221
12222222222222N22222222222221
12222222222222222222222222221
12222222222222222222222222221
12222222222222222222222222221
12222222222222222222222222221
12222222222222222222222222221
12222222222222222222222222221
11111111111111111111111111111
