R  1200 700

NO ./texture/brick_wall.XPM
SO ./texture/brick_wall.XPM
WE ./texture/wood_wall.XPM
EA ./texture/wood_wall.XPM
S ./texture/frfrance.XPM

F 86,125,70
C 0,191,235

11111111111111111111111111111
10000000000000000000000000001
10000000000000000000000000001
10000000000000000000000000001
10000000000000000000000000001
10000000000000000000000000001
10000000000000000000000000001
10000000000000N00000000000001
10000000000000000000000000001
10000000000000000000000000001
10000000000000000000000000001
10000000000000000000000000001
10000000000000000000000000001
11111111111111111111111111111
