R  1080 720

NO /path_to_the_north_texture
SO ./path_to_the_south_texture
WE ./path_to_the_west_texture
EA ./path_to_the_east_texture
S ./texture/Frfrance.XPM

F 86,125,70
C 135,206,235

11111111111111111111111111111
11111111111111111111000000001
11111111111111111111000000001
11111111111111111111000000001
10000000000000000000000000001
10000000000111111000001111111
10000000000111111000001111111
10000000000111111000001111111
11111100000000000000000000001
11111100000011110000000000001
10000000000011110000000000001
10000000000000000000000000001
1000000000000N000000000000001
11111111111111111111111111111
