R  1500 750

NO ./texture/grey_wall.XPM
SO ./texture/red_wall.XPM
WE ./texture/blue_wall.XPM
EA ./texture/green_wall.XPM
S ./texture/frfrance.XPM


C          14,          77               ,         146
F 11   ,   102 ,    35

NX ./maps/map2.cub

111111111111111011111111111111111111111111111111111111111111111111
1000000000000000000000000000000000000000000011111111111000000000001
100000000000000000000000000000000000000000001111111111110111111111
100111111111111100000000000000000000111110000000000000000000000000111
100111111111111100000000000000000011111000000000000000000000000000001
10000000000001111000000000000000000011111000000000000000000000000000001
10000000000011110000000011
11000200011111000000000000000000000000000001
10000S200000011111111111000000111111000000000000000000000000000000111
10020020000111111111111110111111110000001111111111110011111111111
1000000000000111100000000000000000000000001111111111110011111111111
1000000000011110000000000000000000000000000000000000000000000001
1000000000000111100000000000000000000000000000000000000000000000001
101
1000000001000000001
1000000000000000000000000001111111000000000000000001111111001
10000000000000000000000000000000011111111111111111110000000000000001
1000000000000000000000000000000000000000000001000000000000001
111111111111111111111111111111111111111111101111111111111111111111
