R 1500 900
NO ./texture/brick_wall.XPM
SO ./texture/brick_wall.XPM
WE ./texture/wood_wall.XPM
EA ./texture/wood_wall.XPM
S ./texture/frfrance.XPM

F 86,125,70
C 0,191,235

1111111111111111111111111111111111111111111111111111111111111111111
1000000000000000000000000000000000000000000011111111111000000000001
1000000000000000000000000000000000000000000011111111111101111111101
1001111111111111000000000000000000001111100000000000000000000000001
1001111111111111000000000000000000001111100000000000000000000000001
1000000000000111100000000000000000001111100000000000000000000000001
1000000000000111100000000111100000001111100000000000000000000000001
1000000000000111111111110000001111110000000000000000000000000000001
1000000000000111111111111110111111110000001111111111110011111111111
1000000000000111100000000000000000000000001111111111110011111111111
1000000000000111100000000000000000200000002000000000000000000000001
1000000000000111100000000000002000000002000020000000000000000000021
1000000000000111100000000000000000000000000020000000000000000000101
10000000000000000000000000000000000012000000000000000000000000001N1
1111111111111111111111111111111111111111111111111111111111111111111
