R  1514 750

NO ./texture/brick_wall.XPM
SO ./texture/brick_wall.XPM
WE ./texture/brick_wall2.XPM
EA ./texture/brick_wall2.XPM
S ./texture/frfrance.XPM

F 11,102,35
C 14,77,146

NX maps/map.cub

1111111111111111111111111111111111111111111111111111111111111111111
1000000000000000000000000000000000000000000011111111111000000000001
1000000000000000000000000000000000000000000011111111111101111111101
1001111111111111000000000000000000001111100000000000000000000000001
1001111111111111000000000000000000001111100000000000000000000000001
1000000000000111100000000000000000001111100000000000000000000000001
1000000000000111100000000111100000001111100000000000000000000000001
1000000000000111111111110000001111110000000000000000000000000000001
1000000000000111111111111110111111110000001111111111110011111111111
1000000000000111100000000000000000000000001111111111110011111111111
1000000000000111100000000000000000000200000000000000000000000000001
1000000000000111100000000000000000N00000000000000000000000000000001
1000000000000000000000000000002000000000000000000000000000000000001
1000000000000000000000000000000000000000000000000000000000000000001
1111111111111111111111111111111111111111111111111111111111111111111
