R  1500 750
NO /path_to_the_north_texture
SO ./path_to_the_south_texture
WE ./path_to_the_west_texture
EA ./path_to_the_east_texture
S ./texture/Frfrance.XPM

F 86,125,70
C 135,206,235

1111111111111111111111111111111111111111111111111111111111111111111
1000000000000000000000000000000000000000000011111111111111111111121
1000000000000000000000000000000000000000000011111111111111111111101
1111111111111111000000000000000000001111100000000000000000000000001
1111111111111111000000000200000000001111100000000000000000000000001
1000000000000111100000000000000000001111100000000000000000000000001
1000000000000111100000000000000000001111100000000000000000000000001
1000000000000111111111111111111111110000000000000000000000000000001
1000002000000111111111111112111111110000001111111111111111111111111
1000000000000111100000000000000000000000001111111111111111111111111
1000000000000111100000000000000000000000000000000000000000000000001
1000000000000111100000000000000000002000000000000000000000000000001
1000000000000111100000000000000000000000000000002000000000000000101
10000000000000000000000000000000000000000000000000000000000000001N1
1111111111111111111111111111111111111111111111111111111111111111111
