C 14,77,146
R  1514 750
WE texture/brick_wall2.XPM
NO ./texture/brick_wall.XPM
SO ./texture/brick_wall.XPM

EA ./texture/brick_wall2.XPM


F 11   ,   102,35
S ./texture/frfrance.XPM

1111111111111110011111111111111111111111111111111111111111111111111
1000000000000000000000000000000000000000000011111111111000000000001
100000000000000000000000000000000000000000001111111111110111111111
100111111111111100000000000000000000111110000000000000000000000000111
10011111111111110000000000000000000011111000000000000000000000000000001
10000000000001111000000000000000000011111000000000000000000000000000001
10000000000001111000000001111000000011111000000000000000000000000000001
100000N00000011111111111000000111111000000000000000000000000000000111
10000000000111111111111110111111110000001111111111110011111111111
1000002000000111100000000000000000000000001111111111110011111111111
10000000002011110000000000000000000000000000000000000000000000001
1000000000000111100000000000000000000000000000000000000000000000001
10001
1100000001000000001
1000000000000000000000000001111111000000000000000001111111001
10000000000000000000000000000000011111111111111111110000000000000001
1000000000000000000000000000000000000000000001000000000000001
111111111111111111111111111111111111111111101111111111111111111111
