R  1500 750

NO ./texture/green_wall.XPM
SO ./texture/blue_wall.XPM
WE ./texture/grey_wall.XPM
EA ./texture/red_wall.XPM
S ./texture/frfrance.XPM

F 11,102,35
C 14,77,146

1111111111111111111111111111111111111111111111111111111111111111111
1000000000000000000000000000000000000000000011111111111200000000001
1000000000000000000000000000000000000000000011111111111101111111101
1001111111111111000000000000000000001111100000000000000000000000001
1001111111111111000000000002000000001111100000000000000000000000001
1000000000000111100000000000000000001111100000000000000200000000001
1000000000000111100000000111100000001111100000000000000000000000001
1000000020000111111111110000001111110000000000000000000000000000001
1000000000000111111111111110111111110000001111111111110011111111111
1000000000000111100000000000000000000000001111111111110011111111111
1000000000000111100000000000000000000000000000000000000000000000001
1000000000000111100000000000000000000000000000000000000000000000001
10000000000000000000000000000000000000000000000200000N0000000000001
1000000000000000000000000000000000200000000000000000000000000000001
1111111111111111111111111111111111111111111111111111111111111111111
