R  1500 900
NO ./texture/Mur_big.XPM
SO ./texture/Mur_big.XPM
WE ./texture/wood_wall.XPM
EA ./texture/wood_wall.XPM
S ./texture/Frfrance.XPM

F 86,125,70
C 135,206,235

1111111111111111111111111111111111111111111111111111111111111111111
1000000000000000000000000000000000000000000011111111111000000000021
1000000000000000000000000000000000000000000011111111111101111111101
1001111111111111000000000000000000001111100000000000000000000000001
1001111111111111000000000200000000001111100000000000000000000000001
1000000000000111100000000000000000001111100000000000000000000000001
1000000000000111100000000111100000001111100000000000000000000000001
1000000000000111111111110000001111110000000000000000000000000000001
1000002000000111111111111112111111110000001111111111111111111111111
1000000000000111100000000000000000000000001111111111111111111111111
1000000000000111100000000000000000000000000000000000000000000000001
1000000000000111100000000000000000002000000000000000000000000000001
1000000000000111100000000000000000000000000000002000000000000000101
10000000000000000000000000000000000000000000000000000000000000001N1
1111111111111111111111111111111111111111111111111111111111111111111
