R                   1500 750

NO ./texture/grey_wall.XPM
SO ./texture/red_wall.XPM
WE ./texture/blue_wall.XPM
EA ./texture/green_wall.XPM
S ./texture/frfrance.XPM

C 14,77,146
F 11 ,102,35

NX ./maps/map3.cub

11111111111111111111111111111
10000000000000001111111100001
10000000000000001111111100001
10000000200000000000000000001
10000000000000000000000000001
101111111111110000000000000011111
101111111111110000000000000000001
10000000000000N000000000002000001
100000000000000000000000000011111
10000000000000000000000000001
10000020000000111111111111111
10000000000000111111111111111
10000000000000000000000000001
11111111111111111111111111111
