R  1200 750

NO ./texture/grey_wall.XPM
SO ./texture/red_wall.XPM
WE ./texture/blue_wall.XPM
EA ./texture/green_wall.XPM
S ./texture/frfrance.XPM

F 11,102,35
C 14,77,146

NX maps/map1.cub

111111111111111111111111
100000000000000000000001
100000000000000000000001
100000000000000000000001
100000000000000000000001
1000000000N0000000000001
100000000000000000000001
100000000000000000000001
100000000000000000000001
111111111111111111111111
