R  1200 750

NO ./texture/red_wall.XPM
SO ./texture/red_wall.XPM
WE ./texture/grey_wall.XPM
EA ./texture/grey_wall.XPM
S ./texture/frfrance.XPM

F 11,102,35
C 14,77,146

NX maps/map1.cub

111111111111111111111111
100000000000000000000001
100000000000000000000001
100000000000000000000001
100000000000000000000001
1000000000W0000000000001
100000000000000000000001
100000020000000000000001
100000000000000000000001
111111111111111111111111
