R  1500 750

NO ./texture/grey_wall.XPM
SO ./texture/red_wall.XPM
WE ./texture/blue_wall.XPM
EA ./texture/green_wall.XPM
S ./texture/frfrance.XPM

C 14,77,146
F 11 ,102,35

NX ./maps/map1.cub

11111111111111111111111111111
100000000000000000000000000W1
10011111111111111111111111111
10011111111111111111111111111
10000000000000000000000000001
11111111111111111111111111101
11111111111111111111111111101
10000000000000000000000000001
10111111111111111111111111111
10111111111111111111111111111
10000000200000020000000000001
10000000000200000000020000001
11111111111111111111111111111
